NO ./textures/p_a.xpm
SO ./textures/p_a.xpm
WE ./textures/p_a.xpm
EA ./textures/p_a.xpm

F                       220, 12,3
C 225, 234,30



        1111111111111111111111111
        1001000000000000000000001
        101100000111N000000000001
        1000000000111100000000001
11111111101100000111 100000000001
100000000011000001111111111111111
11110111111111011100000010001
11110111111111011101010010001
11000000110101011100000010001
10000000000000001100000010001
10000000100000001101010010001
11000001110101011110111100111
11110111 1110101 101111010001
11111111 1111111 111111111111