NO ./textures/1wall.xpm
SO ./textures/2wall.xpm
WE ./textures/3wall.xpm
EA  ./textures/4wall.xpm
C 0, 212,               003
F 2  3           3, 55, 000

11111111
110011N1
11111111