NO ./textures/p_a.xpm
SO ./textures/p_a.xpm
F 124, 181, 80
WE ./textures/p_a.xpm
EA ./textures/p_a.xpm
C 160, 00222, 00        255






1111111111111111111111111
1000000000110000N00000001
1011000001110000000000001
1001000000000000000000001
111111111011000001110000111111111
100000000011000001110111111111111
11110111111111011100000010001
11110111111111011101010010001
11000000110101011100000010001
10000000000000001100000010001
10000000000000001101010010001
1100000111010101111101111000111
11110111 1110101 101111010001
11111111111111111111111111111
11
11111111 111111 111111111111
11111111111111111111111111111
1                           1
1                           1
111111111111111111111111111111
